                                                                                 ~~~~~~~~~~~~        ~~~~~~~~~~~~~~                                                                                                                                                            
                                                                ~    ~~  ~ ####~##### ~~~~#########################~~~             ~~####~~          ~~  ~~                 ~####~ ~~                                                                                          
                                                         ~#####~~~  ~~ ~ ~####~~      ~~~~~~#####################~                                          ~###~             ~~~#########~~             ~~~~~~                                                                
                                                  ~####~####~##  ~#~ ~#~## ## ~             ###################                                            ~#       ~#~  ~~###############~~###########~      ~~~~~                                                            
                      ~~~~###########~~~    ~~##~~~   #######~  ~ ###  ~##  ~#####~         ~###############~                         ~########~                ~###~### ###################################################~~~~~~~~~~~~~                                      
                  ~~~~~#################################~#############~       #######     ~##########~       ~  ~~                  ~############  ~  ~#######################################################################################~~~~~                            
                  ~############################################~    ~~       ~####         #####~             ####                #####~  ~###################################################################################################~~                               
              #########~~  #################################~           ~###~                #                                 ########~  ~##~ ####################################################################################     #####~                                 
                ~#~           #############################~           ######~##~                                      #~       ~   ##~   ~################################################################################            ##~                                     
          ~~~                 ##################################~    ~###########~                                    ~ ##       # ~      ################################################################################              ####    ~                              
                             # #################################~  ################                                 ##  ####  ~#################################################################################################~          #                ~  ~~              
                              # ~########################################~      ~#~                                      ~~######################################################################################################  ~                                           
                               ###########################################~                                              ~#######################################################################################################   ~                                          
                             ~########################################~  ~                                                #######~~~  ~########~        ~####~   ~###############################################################    ~#~                                       
                           ~#######################################~                                                ########     ~   #   ######~          #####~   ####################################################~######        ~                                        
                           ####################################~                                                   #######       ~    #   ##   #################    #################################################       #          #                                       
                           ###################################                                                       ~       ~~~~#          ~    ##~~~###########~~~~###################################################~     ##      ###                                      
                            ~##############################~                                                         #############                    ###################################################################~        ####~                                        
                             #~#########################~                                                          ###################~   ####~~  ~~ ~#####################################################################        #                                           
                             ~  ~##########~           #~                                                        ~################################## ~ ##########   ~#######################################################                                                   
                              ~  #########~             #                                                      ######################################~  ##########       ~#################################################                                                    
                                   #######            ~~                                                     ~########################################~   ~#########~~##~         ~#####################################~   #                                                  
                                   #######      ~~       ##~                                                ############################################   ##############~         ~  ##########~     ###########~  ~                                                          
                                     ~#####~~~~##         ~  ###~~                                           ###########################################~    ~#########~              ########~         #########   #         #                                                
                                             ###~~~#                   ~                                    ##############################################    ######                   ~####~           ~  ########~         ##                                                
                                                 ###                  ~                                     ################################################~ ~~                        ####                ########~         #~~                                              
                                                   #       ~####~~  ~                                         ################################################~~~~##~                    ###                #   ##~            ~##~                                            
                                                     # ~ ##############~                                       ~###################################################                         ~#               #                  ~###                                           
                                                         #################~~~                                     ~##~~#~     ###################################~                                        ~   ##          ###     #                                            
                                                        ~######################                                                   ##############################~                                          ##  ##      #####         ~                                         
                                                       ########################~                                                  ###########################~                                               ##~     #######    #   ~   ~                                      
                                                      #############################~                                              ~########################~                                                  ####    #####   ##         #  ~#~                                
                                                      ####################################~                                         ######################                                                       #            ~ ~           ~######~   ~~                      
                                                        ####################################                                         #####################                                                         ~~###~~  ~     ~          #####~ #        ~                 
                                                         #################################~                                          #####################~                                                                     ~                     #          ~             
                                                          ###############################                                            ######################       ~                                                                   ####~     #                              
                                                            ~############################                                           ######################~      ##                                                              ~########~    ###                             
                                                               ~#########################                                           ###################~      ####~                                                            ##############~~###                  ~          
                                                                ~########################                                            #################        ###~                                                         ~########################                           
                                                                ~###################~                                                 #################       ##~                                                      ##############################                          
                                                                 ##################                                                   ##############                                                                   ###############################                         
                                                                 #################                                                      ~##########~                                                                   ###############################                         
                                                                 ###############~                                                        ########~                                                                     #########~~~~~###############~                          
                                                                 ##############                                                          ###~~~                                                                       ####~~~        ############~                             
                                                                 ############                                                                                                                                                           ########                               
                                                                 #########~~                                                                                                                                                             #~~                      ##~          
                                                                  ######~                                                                                                                                                                ###                  ##~              
                                                                   ######                                                                                                                                                                                 ###~                 
                                                                   #####~                                                                                                                                                                              ###                     
                                                                    #####                                                                                                    ~                                                                                                 
                                                                     ####      ~                                                                                                                                                                                               
                                                                      ~##~                    ~                                                                                                                                                                                
                                                                                                                                                                                                                                                                               
                                                                                                                                                                                                                                                                               
                                                                                                                                                                                                                                                                               
                                                                                                                                                                                                                                                                               
                                                                                                                                                                                                                                                                               
                                                                                                                                                                                                                                                                               
                                                                                                                                                                                                                                                                               
                                                                                                                                                                                                                                                                               
                                                                                                                                                                                                                                                                               
                                                                                                                                                                                                                                                                               